10 12
1 1
2
10 1
10 8
GRID
111111111111
100000000001
101110222201
100010000001
103010333001
100010000001
100011111001
100000000001
100000000001
111111111111
