15 20
1 1
4
18 1
18 13
1 13
10 7
GRID
11111111111111111111
10000000000000000001
10111101111101111101
10000201000001000001
11110201011101011101
10000201010001010001
10111101010111010101
10000000010002010001
10111111010102011101
10000001000102000001
10111001111102111101
10001000000000000001
10201033333333011101
10000000000000000001
11111111111111111111
