10 14
1 1
3
12 1
12 8
1 8
GRID
11111111111111
10000220000001
10111011101101
10001000100301
10221010100301
10001010100001
10111010111101
10000010000001
10033300000001
11111111111111
